###                                 #########
#     ###################     # #
# ####                                # # # #
# ################### # # # #
#                                         # # # #
##################### # # # #
#     ##                                # # # #
# # ## ### ## ######### # # #
# #        #     ##B#                 # # #
# # ## ################ # # #
### ##                         #### # # #
### ############## ## # # # #
###                         ##        # # # #
###### ######## ####### # # #
###### ####                         #     #
A            ######################
